00000000
00J00000
0000C000
00000000
0000T000
00000000
0G000000
00000G00