000C0000
00DNND00
0DD00DD0
00000000
00000000
00000000
G000000J
0TT00TT0