0D0D0000
00000D00
00000000
0000N0C0
00000000
00000000
000T0000
0000000G