00000000
00000000
00000000
0000C00T
00000000
00J0T000
00000000
0G000000