000NC000
D000000D
0D0000D0
00D00D00
00000000
00000000
00J00J00
000TG000