0D00D0CN
D0DD0D00
0D00D000
0000000D
00000000
00000000
0J0000J0
00T0GT00