0D0D0000
00000D00
00000000
00D000C0
00000000
00000000
000T0000
00000000