00000000
00J00000
0000C000
00N00000
0000000D
00000000
0G0T0J00
00000G00